ID	Name
Uprt.Pno	Upright Pno.
UprtP. w	Uprt Piano w
MildP. w	Mild Piano w
EuropePf	European Pf
PianoStr	Piano+Str. 1
Pno+Str2	Piano+Str. 2
DreamPno	Dream Piano
DreamP.2	Dream Piano2
PopPno w	Pop Piano w
RockP. w	Rock Piano w
DancePno	Dance Piano
EGRhode1	EG+Rhodes 1
EGRhode2	EG+Rhodes 2
HnkyTk w	Honky Tonk w
Old Uprt	Old Upright
HnkyTnk2	Honky Tonk 2
Det.EP 1	Detuned EP 1
StSoftEP	Ste. Soft EP
SilntRho	SilentRhodes
Dst.EPno	Dist. EPiano
60sElPno	60s' E.Piano
HrdRhode	Hard Rhodes
MelRhode	Mellow Rhode
ElPiano3	Elec.Piano 3
Det.EP 2	Detuned EP 2
Det.EP 3	Detuned EP 3
ElPno 2v	El. Piano 2v
St.FM EP	Stereo FM EP
HardFMEP	Hard FM EP
CplHapsi	CoupledHapsi
SynHapsi	Synth Harpsi
AtkClavi	Attack Clavi
AtkClv.2	Atk. Clavi 2
Comp Clv	Comp Clavi.
Reso Clv	Reso Clavi.
PhaseClv	Phase Clavi.
Clavi. o	Clavichord o
AnaClavi	Analog Clav.
JP8 Clv1	JP8 Clav. 1
JP8 Clv2	JP8 Clav. 2
SyRngClv	Syn.Ring Clv
SyDstClv	Syn.Dist Clv
JP8k Clv	JP8000 Clav.
PulseClv	Pulse Clavi.
PopCelst	Pop Celesta
MusicBx2	Music Box 2
St.MusBx	St.Music Box
HardVibr	Hard Vibra.
Vib. w	Vibes. w
Vibra. w	Vibraphone w
Vibrafns	Vibraphones
Xylofn.w	Xylophone w
ChrchBel	Church Bell
ChchBel2	Church Bell2
TubBel w	TubularBel w
FullOrgn	Full Organ
FullOrg2	Full Organ 2
FullOrg3	Full Organ 3
FullOrg4	Full Organ 4
FullOrg5	Full Organ 5
FullOrg6	Full Organ 6
DetDrwOr	Detuned Org.
TremDrOr	Tremolo Org.
FullOrg7	Full Organ 7
FullOrg8	Full Organ 8
FullOrg9	Full Organ 9
60sDrOrg	60s' Organ 1
60sDrOr2	60s' Organ 2
60sDrOr3	60s' Organ 3
CheezOrg	Cheese Organ
HybridOr	Hybrid Organ
EChrchOr	Digi. Church
JX-8P Or	JX-8P Organ
5thOrgan	Fifth Organ
EOrg16+2	E.Organ 16+2
JazzOrg2	Jazz Organ 2
JazzOrg3	Jazz Organ 3
JazzOrg4	Jazz Organ 4
JazzOrg5	Jazz Organ 5
JazzOrg6	Jazz Organ 6
DetPrcOr	Detuned Or.2
ChorusOr	Chorus Organ
OctaveOr	Octave Organ
PercOrg3	Perc Organ 2
PercOrg4	Perc Organ 3
PercOrg5	Perc Organ 4
PercOrg6	Perc Organ 5
RotaryOr	Rotary Organ
SlwRotar	Slow Rotary
RockOrg2	Rock Organ
RockOrg3	Rock Organ 2
FstRotar	Fast Rotary
ChurOrg2	Church Or. 2
ChurOrg3	Church Or. 3
OrgFlute	Organ Flute
TrmOrgFl	TrmOrgnFlute
ThtreOrg	Theatre Org.
AccordIt	Accordion It
DstAcord	Dist. Accord
ChoAcord	Chorus Acc.
HrdAcord	Hard Accord.
SftAcord	Soft Accord.
Harmo. 2	Harmonica 2
BscBHrmo	BasicB.Harmo
SplBHrmo	SupplB.Harmo
TngoAcd2	Bandoneon 2
Bndoneon	Bandoneon 3
12StrGtr	12Str Guitar
ClnHalfG	Clean Half G
OpnHrdGt	Open Hard Gt
OpnHrdG2	Open Hard G2
JC ClnGt	JC Clean Gt.
TCFrntPk	TCFront Pick
TCRearPk	TC Rear Pick
LPRearPk	LP Rear Pick
MidT.Gtr	Mid Tone Gtr
TCMuteGt	TCMuted Gtr.
Funk Gtr	Funk Guitar
OvrDrGt2	OvrDrvGtr. 2
OvrDrGt3	OvrDrvGtr. 3
MoDrvGtr	MoreDrive Gt
LPOvrDr2	LPOverdrive2
WildAcBa	Wild Ac.Bass
AtkAcoBa	AtkAcou.Bass
JazzyBa2	Jazzy Bass 2
F.Ba/Hrm	F.Bass/Harm.
PickBas3	Picked Bass3
PickBas4	Picked Bass4
DblPikBa	Dbl.PickBass
WoodFrtl	Wood+Fretles
SlapBass	Slap Bass 1
ResoSlap	Reso Slap Ba
SynBa101	SynthBass101
Reso 303	Reso 303Bass
ResoSHBa	Reso SH Bass
303SqrBa	303 Sqr. Ba.
303DstBa	303 Dist Ba.
JungleBa	Jungle Bass
303SqDst	303 SqDistBa
303SqDs2	303 SqDstBa2
303SqDs3	303 SqDstBa3
303SqrRv	303 Sqr. Rev
SynBa201	Syn.Bass 201
MGOctBa2	MGOctaveBas2
BeefFMBa	Beef FM Bass
ViolnAtk	Violin Atk.
ViolaAtk	Viola Attack
CelloAtk	Cello Attack
SlwTrStr	Slow Tremolo
VcCbPizz	Vc/Cb Pizz.
St. Pizz	Stereo Pizz.
StrsSpic	Strings Spic
UileanHp	Uillean Harp
Slow Str	Slow Strings
Mild Str	Mild Strings
OrchStr2	Orchestra 2
OrchStr3	Orch. Str 3
Syn.Str3	SynthString3
Air Str.	Air Strings
MltChoir	Melted Choir
OohsMaj7	Oohs (maj7)
OohsSus4	Oohs (sus4)
FemChoLa	FemaleCh.Lah
FemChoLu	FemaleCh.Luh
FemChLan	FemaleCh.Lan
F.La&Lan	FemaleLa&Lan
MalChoWa	Male Cho.Wah
SyVoice2	Syn.Voice 2
Trp&Noiz	Trumpt&Noise
BassTrom	Bass Trmbone
CMuteTrp	Cup MutedTrp
SlwFrHrn	Slow Fr.Horn
RipFrHrn	Rip Fr. Horn
BoneSect	Bone Section
Trp Fall	Trumpet Fall
OrchBras	Orch. Brass
OrchBrs2	Orch.Brass 2
StOrBrs2	St.Orch.Brs2
StOrBrs3	St.Orch.Brs3
SynBras3	SynthBrass 3
SynBras4	SynthBrass 4
Exp.Alto	Express Alto
Sax Sect	Sax Section
BsClari.	BassClarinet
TinWhsNm	TinWhistleNm
TinWhsOr	TinWhistleOr
MGSquare	MG Square Ld
HolwMini	Hollow Mini
CC Solo	CC Solo Lead
JP-8 Sqr	JP-8 Square
DsSquare	Dist. Square
JP8Pulse	JP8 Pulse Ld
JP8Puls2	JP8 Pulse 2
MGRezPls	MG Rez.Pulse
GR-300	GR-300 Lead
D-50 Fat	D-50 FatLead
CS SawLd	CS Saw Lead
OB Saw 2	OB SawLead 2
P5 SawLd	P5 Saw Lead
Seq.Saw.	SequencedSaw
Reso Saw	Resonant Saw
FatGR Ld	Fat GR Lead
JP8BaLd1	JP8BassLead1
ThickMtx	Thick Matrix
OBSoftPd	OB Soft Pad
SynMalet	Synth Mallet
Altrnate	Alternative
Reso Pan	Resonant Pan
UillPpNm	UileanPipeNm
UillPpOr	UileanPipeOr
RideCym!	Ride Cymb.!!
RideBel!	Ride Bells!!
909 Clap	909 HandClap
HandClp!	Hand Clap!!!
Kick3 !!	Kick 3 Menu
Kick4 !!	Kick 4 Menu
MeloTom2	Melod. Tom 2
ElecPerc	Elec Perc 1
Str.Slap	String Slap
CutNoiz2	Cut Noise 2
DstCutNz	DistCutNoise
P.Scrape	Pick Scrape
Gtr.Fx!!	Gtr. FX Menu
BartkPiz	Bartok Pizz.
Gtr.Slap	Guitar Slap
ChrdStrk	Chord Stroke
BiwaStrk	Biwa Stroke
BiwaTrem	Biwa Tremolo
GtStrk!!	Gtr.Stroke!!
GtSlide!	Gtr.Slide!!!
Fl.KClik	FluteKyClick
BrthNz!!	Breath Nz!!!
VoxBrth2	VoiceBreath2
TrumptNz	Trumpet Nz.
White Nz	White Noise
HorseGlp	Horse Gallop
DoorSqek	Door Squeak
ScratchC	Scratch Cut
Scratch2	ScratchSplit
ScrachKy	Scratch Key
TapeRwnd	Tape Rewind
PhonNoiz	Phono Noise
MC500 Bp	MC-500 Beep
CarTyreS	Car Tyre Scr
Car Pass	Car Passing
Calclate	Calculating
AudioSwi	Audio Switch
CarStar2	Car Start 2
LaughVox	Laugh Voice
ScreamVx	Scream Voice
ApplzWav	ApplauseWave
Voice 3	Voice Three
MchinGun	Machine Gun
Xploshn2	Explosion 2
SynBrass	SynthBrass 1
MelloGrP	Mellow Grand
ElPiano4	Elec.Piano 4
ElecOrgn	Elec Organ 1
ElecOrg2	Elec Organ 2
ElecOrg3	Elec Organ 3
ElecOrg4	Elec Organ 4
PipeOrgn	Pipe Organ 1
PipeOrg2	Pipe Organ 2
PipeOrg3	Pipe Organ 3
Clavi. 2	Clavichord 2
Clavi. 3	Clavichord 3
Syn.Bass	Synth Bass 1
HarmoPan	Harmonic Pan
FunnyVox	Funny Voices
Dr. Solo	Doctor Solo
Sch.Daze	School Daze
Sqr.Lead	Square Wave
Str Sect	Str. Sect. 1
StrSect2	Str. Sect. 2
StrSect3	Str. Sect. 3
Elec.Gtr	ElecGuitar 1
ElecGtr2	ElecGuitar 2
Vibrfon2	Vibraphone 2
BrthPipe	Breathy Pipe
El.Perc2	Elec Perc 2
1NoteJam	One Note Jam
JnglTune	Jungle Tune
StdrdL/R	Standard L/R
HipHopKt	Hip Hop Kit
Room L/R	Room Kit L/R
Jazz L/R	Jazz Kit L/R
BrushKt2	Brush Kit 2
Brush2LR	Brush 2 L/R
KkSnare2	Kick Snare 2
GamelnKt	Gamelan Kit
GamlnKt2	Gamelan Kt 2
RyFX Kit	Rhy.FX Kit
RyFX2 Kt	Rhy.FX Kit 2
RyFX3 Kt	Rhy.FX Kit 3
CymblKt2	Cymbal Kit 2