ID	Name
AnalogT9	Analog T9
BackPdMW	BackPad MW
BaladKey	Ballad Key
BobbyBas	Bobby Bass
BlyDance	BellyDance
BreakKit	Break Kit
Chromsme	Chromosome
FulGrand	Full Grand
HellFire	Hell Fire
IrishPpe	Irish Pipe
PolyTrnc	PolyTrance
PWM Perc	PWM Percu.
R&B Kit1	R&B Kit 1
ScrtchKt	ScratchKit
SinglOsc	Single Osc
Spec.SFX	SpecialSFX
SynPopKt	SynPopKit
TranceBa	TranceBass
TrncMelo	TranceMelo
Wave Pan	WavePanner
Whisperr	Whisperer