ID	Name
ElegantS	Elegant S700
Bright S	Bright S700
FulGrand	FullGrandPno
HousePno	House Piano
BaladKey	Ballad Keys
ChrchOoh	Church Oohs
PWM Perc	PWM Percuss.
NaturalS	Natural S700
AnalogT9	AnalogT9 Kit
ScrtchKt	ScratchesKit
SynPopKt	SynthPopKit
BlyDance	BellyDanceKt
Spec.SFX	Special SFX
BackPdMW	Back Pad MW
SinglOsc	Single Osci.
British	British Lead
Wave Pan	Wave Panner
TrncMelo	Trance Melod
TranceBa	Trance Bass
PolyTrnc	Poly Trance